additional lemon zest for topping&&&&all-purpose flour&&&&baking powder&&&&butter melted&&&&canola oil&&&&cayenne pepper or to taste&&&&chopped cilantro&&&&confectioners' sugar&&&&egg whites&&&&finely chopped pecans&&&&finely shredded lemon zest&&&&fish fillets fresh or thawed&&&&for brownies&&&&for chocolate glaze&&&&for lemon frosting&&&&fresh lemon juice divided or as needed&&&&ghirardelli\xc2\xae 60% cacao bittersweet chocolate baking chips&&&&granulated sugar&&&&green onions chopped&&&&ground cinnamon&&&&honey&&&&large egg&&&&light-color corn syrup&&&&mango diced&&&&packed brown sugar&&&&pecan coating&&&&pineapple mango salsa&&&&pineapple tidbits drained&&&&plain dry bread crumbs&&&&red bell pepper diced&&&&red wine vinegar&&&&reynolds wrap\xc2\xae non-stick foil&&&&salt&&&&semisweet chocolate chips&&&&shredded coconut&&&&unsalted butter&&&&unsalted butter softened&&&&vanilla extract&&&&water&&&&whole wheat flour
0 1 1 3 2 3 3 1 2 3 1 3 1 1 1 1 1 1 3 2 2 1 1 3 2 3 3 3 3 3 3 3 2 2 3 1 1 1 2 2 
1 0 2 2 1 2 2 1 1 2 1 2 1 1 1 1 1 1 2 1 1 1 1 2 1 2 2 2 2 2 2 2 1 1 2 1 1 2 1 1 
1 2 0 2 1 2 2 1 1 2 1 2 1 1 1 1 1 1 2 1 1 1 1 2 1 2 2 2 2 2 2 2 1 1 2 1 1 2 1 1 
3 2 2 0 2 1 1 3 2 1 3 1 3 3 3 3 3 3 1 2 2 3 3 1 2 1 1 1 1 1 1 1 1 2 1 3 3 2 2 2 
2 1 1 2 0 2 2 2 1 2 2 2 2 2 2 2 2 2 2 1 1 2 2 2 1 2 2 2 2 2 2 2 1 1 2 2 2 1 1 1 
3 2 2 1 2 0 1 3 2 1 3 1 3 3 3 3 3 3 1 2 2 3 3 1 2 1 1 1 1 1 1 1 1 2 1 3 3 2 2 2 
3 2 2 1 2 1 0 3 2 1 3 1 3 3 3 3 3 3 1 2 2 3 3 1 2 1 1 1 1 1 1 1 1 2 1 3 3 2 2 2 
1 1 1 3 2 3 3 0 2 3 1 3 1 1 1 1 1 1 3 2 2 1 1 3 2 3 3 3 3 3 3 3 2 2 3 1 1 1 2 2 
2 1 1 2 1 2 2 2 0 2 2 2 2 2 2 2 2 2 2 1 1 2 2 2 1 2 2 2 2 2 2 2 1 1 2 2 2 1 1 1 
3 2 2 1 2 1 1 3 2 0 3 1 3 3 3 3 3 3 1 2 2 3 3 1 2 1 1 1 1 1 1 1 1 2 1 3 3 2 2 2 
1 1 1 3 2 3 3 1 2 3 0 3 1 1 1 1 1 1 3 2 2 1 1 3 2 3 3 3 3 3 3 3 2 2 3 1 1 1 2 2 
3 2 2 1 2 1 1 3 2 1 3 0 3 3 3 3 3 3 1 2 2 3 3 1 2 1 1 1 1 1 1 1 1 2 1 3 3 2 2 2 
1 1 1 3 2 3 3 1 2 3 1 3 0 1 1 1 1 1 3 2 2 1 1 3 2 3 3 3 3 3 3 3 2 2 3 1 1 1 2 2 
1 1 1 3 2 3 3 1 2 3 1 3 1 0 1 1 1 1 3 2 2 1 1 3 2 3 3 3 3 3 3 3 2 2 3 1 1 1 2 2 
1 1 1 3 2 3 3 1 2 3 1 3 1 1 0 1 1 1 3 2 2 1 1 3 2 3 3 3 3 3 3 3 2 2 3 1 1 1 2 2 
1 1 1 3 2 3 3 1 2 3 1 3 1 1 1 0 1 1 3 2 2 1 1 3 2 3 3 3 3 3 3 3 2 2 3 1 1 1 2 2 
1 1 1 3 2 3 3 1 2 3 1 3 1 1 1 1 0 1 3 2 2 1 1 3 2 3 3 3 3 3 3 3 2 2 3 1 1 1 2 2 
1 1 1 3 2 3 3 1 2 3 1 3 1 1 1 1 1 0 3 2 2 1 1 3 2 3 3 3 3 3 3 3 2 2 3 1 1 1 2 2 
3 2 2 1 2 1 1 3 2 1 3 1 3 3 3 3 3 3 0 2 2 3 3 1 2 1 1 1 1 1 1 1 1 2 1 3 3 2 2 2 
2 1 1 2 1 2 2 2 1 2 2 2 2 2 2 2 2 2 2 0 1 2 2 2 1 2 2 2 2 2 2 2 1 1 2 2 2 1 1 1 
2 1 1 2 1 2 2 2 1 2 2 2 2 2 2 2 2 2 2 1 0 2 2 2 1 2 2 2 2 2 2 2 1 1 2 2 2 1 1 1 
1 1 1 3 2 3 3 1 2 3 1 3 1 1 1 1 1 1 3 2 2 0 1 3 2 3 3 3 3 3 3 3 2 2 3 1 1 1 2 2 
1 1 1 3 2 3 3 1 2 3 1 3 1 1 1 1 1 1 3 2 2 1 0 3 2 3 3 3 3 3 3 3 2 2 3 1 1 1 2 2 
3 2 2 1 2 1 1 3 2 1 3 1 3 3 3 3 3 3 1 2 2 3 3 0 2 1 1 1 1 1 1 1 1 2 1 3 3 2 2 2 
2 1 1 2 1 2 2 2 1 2 2 2 2 2 2 2 2 2 2 1 1 2 2 2 0 2 2 2 2 2 2 2 1 1 2 2 2 1 1 1 
3 2 2 1 2 1 1 3 2 1 3 1 3 3 3 3 3 3 1 2 2 3 3 1 2 0 1 1 1 1 1 1 1 2 1 3 3 2 2 2 
3 2 2 1 2 1 1 3 2 1 3 1 3 3 3 3 3 3 1 2 2 3 3 1 2 1 0 1 1 1 1 1 1 2 1 3 3 2 2 2 
3 2 2 1 2 1 1 3 2 1 3 1 3 3 3 3 3 3 1 2 2 3 3 1 2 1 1 0 1 1 1 1 1 2 1 3 3 2 2 2 
3 2 2 1 2 1 1 3 2 1 3 1 3 3 3 3 3 3 1 2 2 3 3 1 2 1 1 1 0 1 1 1 1 2 1 3 3 2 2 2 
3 2 2 1 2 1 1 3 2 1 3 1 3 3 3 3 3 3 1 2 2 3 3 1 2 1 1 1 1 0 1 1 1 2 1 3 3 2 2 2 
3 2 2 1 2 1 1 3 2 1 3 1 3 3 3 3 3 3 1 2 2 3 3 1 2 1 1 1 1 1 0 1 1 2 1 3 3 2 2 2 
3 2 2 1 2 1 1 3 2 1 3 1 3 3 3 3 3 3 1 2 2 3 3 1 2 1 1 1 1 1 1 0 1 2 1 3 3 2 2 2 
2 1 1 1 1 1 1 2 1 1 2 1 2 2 2 2 2 2 1 1 1 2 2 1 1 1 1 1 1 1 1 1 0 1 1 2 2 1 1 1 
2 1 1 2 1 2 2 2 1 2 2 2 2 2 2 2 2 2 2 1 1 2 2 2 1 2 2 2 2 2 2 2 1 0 2 2 2 1 1 1 
3 2 2 1 2 1 1 3 2 1 3 1 3 3 3 3 3 3 1 2 2 3 3 1 2 1 1 1 1 1 1 1 1 2 0 3 3 2 2 2 
1 1 1 3 2 3 3 1 2 3 1 3 1 1 1 1 1 1 3 2 2 1 1 3 2 3 3 3 3 3 3 3 2 2 3 0 1 1 2 2 
1 1 1 3 2 3 3 1 2 3 1 3 1 1 1 1 1 1 3 2 2 1 1 3 2 3 3 3 3 3 3 3 2 2 3 1 0 1 2 2 
1 2 2 2 1 2 2 1 1 2 1 2 1 1 1 1 1 1 2 1 1 1 1 2 1 2 2 2 2 2 2 2 1 1 2 1 1 0 1 1 
2 1 1 2 1 2 2 2 1 2 2 2 2 2 2 2 2 2 2 1 1 2 2 2 1 2 2 2 2 2 2 2 1 1 2 2 2 1 0 1 
2 1 1 2 1 2 2 2 1 2 2 2 2 2 2 2 2 2 2 1 1 2 2 2 1 2 2 2 2 2 2 2 1 1 2 2 2 1 1 0 
